XXXXXXXXXXXX
X__________X
X_XXXXXXXX_X
X_XXXXXXXX_X
X_XXXXXXXX_X
X_XXXXXXXX_X
X_XXXXXXXX_X
X_XXXXXXXX_X
X_XXXXXXXX_X
X_XXXXXXXX_X
XS_________G
XXXXXXXXXXXX