XXXXXXX
G_____X
XXXXX_X
X_____X
X_XXXXX
X____SX
XXXXXXX