XXXXXXXXXXXX
X_X______X_X
X_X_XXXXXX_X
X_X________X
X_X_XXXXXX_X
X_X____X___X
X_XXX_SX_X_X
X___XXXX_X_X
X_X_X__X_X_X
X_X_X_XX_X_X
X_X______X_X
XGXXXXXXXXXX