XGXXXXXXXXXX
X__________X
X_XXXXXXXX_X
X_XXXXXXXX_X
X_XXXXXXXX_X
X_XXXXXXXX_X
X_XXXXXXXX_X
X_XXXXXXXX_X
X_XXXXXXXX_X
X_XXXXXXXX_X
XS_________X
XXXXXXXXXXXX